R 600 600
NO ./pathtotexture
EA ./pathtotexture
SO ./pathtotexture
WE ./pathtotexture

S ./pathtotexture
F 255,255,255
C 255,255,255


1111111111111
1001001000011
1000000000001
1000111100001
1001010101111
1111000000001
1000000111001
1010010001011
1010110101001
1010000000001
1011100000001
1000000000011
1111111000011
1000000000001
1000000000011
1111111111111

