R 1000 800

NO ./textures/brick.xpm
SO ./textures/wood.xpm
WE ./textures/metal.xpm
EA ./textures/grass.xpm

F 202,248,220
C 135,206,250
S ./textures/barrel.xpm

111111111111111111111111
100000000000000000000001
102000002100000000111001
102000000000000000000001
100000000000000022220001
111111111000000000000001
100000001000000000000001
100100001000000000000001
1001111110000000N0000001
100000000000000000000001
111111111111111111111111
