R 1000 800
NO ./textures/brick.xpm
SO ./textures/wood.xpm
WE ./textures/metal.xpm
EA ./textures/grass.xpm


F 202,248,220
C 135,206,250

S ./textures/barrel.xpm

11111111111111
10000000000001
1000000N000001
10000010101001
11100001111101
10000000000001
10020200111111
10000000000001
11111111111111
