R  1000 1000
SO ./textures/wood.xpm
WE 				./textures/metal.xpm
EA     ./textures/grass.xpm
NO ./textures/brick.xpm

S 	./textures/barrel.xpm

F 200,255,    255
C 255,   30    ,0

11111111111111111
10011100000101111
10001100000001111
10000000000000111
10000000002000001
11110000000S00001
111100000000011111
10000000000111
1111111111111111
