S ./textures/barrel.xpm

SO ./textures/Grey1.xpm
WE ./textures/Stone3.xpm
EA ./textures/Sr1.xpm
NO ./textures/Brown21.xpm
R 1080       720
F      220,100,    0
C    225     ,			30,0


111
101
101
101
1011111111111
1001001000011
1000000000001       1111111111
1000111100001       1000000001
1001010101111       1000000001
1111000000001       1111001111
1000000111001          1001
101001000101111111111111001
101011000000000000000000001
10102000W000111101111111111
1000000020001  111
1000000000011
1111111000011
1000000000001
1000000000011
1111111111111











