R 1000 1000
S ./textures/barrel.xpm

SO ./textures/Grey1.xpm
WE ./textures/Stone3.xpm
EA ./textures/Sr1.xpm
NO ./textures/Brown21.xpm


F 202,   248,220
C 135  ,206,250

1111111111111111111111111
1000000000110000000000001
1011000001110000002000001
1001000000000000000000001
111111111011000001110000000000001     11111111
100000000011000001110111111111111     10000001
111111101110000001000000000001        11100111
111101111111110111010100100001          1001
11000000110101011100000010000111111111111001
10002000000000001100000010000000000000000001
10000000000000000000000000000111111111111111
11000001110101011111011110N0111
11110111 1110101 101111010001
11111111 1111111 111111111111

